11111111111111111111
10001110000000111001
10111111000011111101
10111111111111111101
10111111111111111101
10111111111111111101
10111111111111111001
10011111111111110001
10001111111111100001
10000111111111000001
10000011111110000001
10000001111100000001
10000000000000000001
10000000000000000001
10000000000000200001
11111111111111111111