00000000000000000000
00111110000001111100
00100000000000000100
00100000000000000100
00100000000000000100
00100000000000000100
00000000000000000000
00000001111110000000
00000001000010000000
00000001000010000000
00000001000010000000
00000001111110000000
00000000000000000000
00000000000000000000
00100000000000000100
00100000000000000100
00100000000000000100
00100000000000000100
00111110000001111100
00000000000000000000
