11111111111111111111
10000000011000000001
10111111000011111101
10100001000010000101
10100001000010000101
10000000000000000001
10001111111111110001
10000000000000000001
10001000022000010001
10001111111111110001
10000000000000000001
10100201000010200101
10100001000010000101
10111111000001111101
10002000001100020001
11111111111111111111