0000000000000000000
0011111000001111100
0010000000000000100
0010000000000000100
0010000000000000100
0010000000000000100
0000000000000000000
0000001111110000000
0000001000010000000
0000001000010000000
0000001000010000000
0000001111110000000
0000000000000000000
0000000000000000000
0010000000000000100
0010000000000000100
0010000000000000100
0010000000000000100
0011111000001111100
0000000000000000000
