11111111111111111111
10000000001111111101
10111111000011111101
10100001000000200101
10100001000000000101
10111111000011111101
10000000000000000001
10001111111111110001
10000000000000000001
10001000022000010001
10001111111111110001
10111111000011111101
10100201000000200101
10100001000010000101
10002000001100020001
11111111111111111111